[meta]
limit= 25

[map]
layout= @.........e..............
	.........................
	........###..............
	.....e................e..
	######.........##########
	.........................
	...........##............
	.........................
	####.###..........#######
	......#####.......#######
	###..............########