[meta]
limit= 78

[map]
layout= ..............................................................................
	..............................................................................
	..............................................................................
	..............................................................................
	..............................................................................
	..............................................................................
	..............................................................................
	..............................................................................
	..............................................................................
	.......................++..e.............................+....................
	..e...................??????............................?#....................
	..?......??...................................................................
	.............................................................e......e....e...e
	@.............e.........$$$$$$..e.....e.....##################################
	####################..#################.......................................