[meta]
limit= 25

[map]
layout= @........................
	.........................
	........###..............
	.........................
	######.........##########
	.........................
	.........................
	.........................
	.........................
	.........................
	##########.....##########